كناءس		كنيسة
عمليات		عملية
احفاد		حفيد
كيزان		كوز
برامج		برنامج
رءوس		رءس
ديدان		دودة
جراثيم	جرثومة
مواعيد	موعد
اجنه		جنين
اعمدة		عامود
قرابين	قربان
عصافير	عصفور
اعضاء		عضو	
غدد		غدة
فيران		فار
اوعية		وعاء
مزايا		ميزة
قنوات		قناة
عيدان		عود
سنادات	سند
اسابيع	اسبوع
اواني		اناء
تكاليف	تكلفة
انسجة		نسيج
مصايد		مصيدة
قدماء		قديم
هجن		هجين
محاصيل	محصول
قوائم		قائمة
اتربة		تراب
اماكن		مكان
محاريت	محرات 
زراع		زارع
قنوات		قناة
سنيبلات	سنبلة
اصداء		صدأ
اعباء		عبء
اجنحه		جناح
فئران		فأر
علائق		علقة
تكاليف	تكلفة
طرق		طريقة
خنافس		خنفساء
شرائط		شريط
شرائح		شريحة
مربو		مربي
اخصائيو	اخصائي
مواد		مادة
بدائل		بديل
اراضي		ارض
محاريت	محرات
قمم		قمة
مربات		مرأة
شباب		شاب
غرابيل	غربال
اطارف		طرف
اعداء		عدو
خسائر		خسارة
دلائل		دليل
اشرطة		شريط
سكاكين	سكين    
اواني		اناء
سيقان		ساق
عناكب		عنكبوت
التهابات	التهاب
احذية		حذاء 
انابيب	انبوب
اوائل		اول
بساتين	بستان
مواسير	ماسورة
بلاد		بلد
عباقرة	عبقري
جداول		جدول
مرافق		مرفق
صحاري		صحراء
اجهزه		جهاز
بسطاء		بسيط
اصحاب		صاحب
طلاب		طالب
شوارع		شارع
مساكن		مسكن
صناديق	صندوق
رواتب		راتب
ظباط		ظابط
مشاريع	مشروع
نواب		نائب
رشاوي		رشوه 
وكلاء		وكيل 
أقباط		قبطي 
دعاة		داعية 
مستشفيات	مستشفى 
وزراء		وزير
قضاه		قاضي
فوانيس	فانوس
علماء		عالم
طوابير	طابور
شهداء		شهيد
جماهير	جمهور
قوانين	قانون
اطباء		طبيب
اساليب	اسلوب
مدن		مدينة
خبراء		خبير
بحاث		باحث
رؤساء		رئيس
مبادئ		مبدء
خطط		خطة
رواد		رائد
حصص		حصة 
عظماء		عظيم 
عساكر		عسكري
ميادين	ميدان 
وزراء		وزير
قضاه		قاضي
فوانيس	فانوس
طوابير	طابور
رسائل		رسالة
فقراء		فقير
افلام		فيلم
سفن		سفينة
فواتير	فاتورة
اسهم	 	سهم      
شقق	 	شقة      
شبان		شاب       
غزلان	   	غزال       
خرفان	 	خروف       
صلبان	   	صليب      
المان	  	الماني      
امريكان	امريكي
اسنان		سنة      
بطاطين	بطنية
مساجين	مسجون
سنوات		سنة
مباريات	مبارة
قنوات		قناة
ملوك		ملك
معارك		معركة
قرات		قراة
كتاكيت	كتكوت	
كوبونات	كبون
كميات		كمية
كروت		كرت
كومنتات		كومنت
كمنتات		كمنت
كاوتشات		كاوتش
كنايس		كنيسة	
كنوز		كنز
محاكم		محكم	
بنوك		بنك
بنزينات		بنزينة
فيديوهات	فيديو
فتوة      فتاوي
فاعليات		فاعليا
فعاليا		فعليا
فتيات		فتاة
فاكسات		فاكس
فءويات		فءة
فترات		فترة
فريندز		فريند
فضاءيات		فضاءة
فضايح		فضيحة
فواتير		فتورة
فواءد		فءادة
فيروسات		فيروس
هتافات		هتاف
وساءل		وسيل 
وزراء		وزير
عملاء		عميل
مطالب		مطلب
هواتاف		هاتف
ايام		يوم
لجان		لجنة
لجنه		لجنة 
قنابل		قنبل
احكام		حكم
ابطال		بطل
مشاكل		مشكل
شءون		شءن
حوادث		حادث
كلاب			كلب
تقارير		تقرير
اصوات		صوت
ولاد			ولد
فلول		فلل
جلسات		جلسة
حلول		حل
جلسات		جلسة
شرفاء		شريف
مواقع		موقع
انصار		نصير
اوقات		وقت
ازايز		ازازة    
اسري		اسير
نشطاء		ناشط
اركان		ركن
نجوم		نجم
اوقات		وقت 
نشطاء		نشيط
اركان		ركن
باقات		باقة
مسابقات		مسابقة
مواقع	  	موقع
تجار	  	تاجر
اسباب	  	سبب
اوراق	  	ورق
حكام		حاكم
زراير		زورار
الكناءس		كنيسة
انفس		نفس
اجانب		اجنبي
قضايا		قضية
اكواد		كود 
رساءل		رسالة
سنوات		سنة 
رموز		رمز
شباب		شاب
اهالي		اهل
جراءم		جريمة
جرائد		جريدة
بلاوي		بلوة
رسايل		رسالة
ادلة		دليل
سجون		سجن
جوايز		جاءزة
ميادين		ميدان
الستات		ستت
اتباع		تابع
اصوات		صوت
اسعار		سعر
سفراء		سفير
عقول		عقل
اعداد		عدد
سجاءر		سيجار
فنادق		فندق
مبادء		مبدء
اطنان		طنن
اصابع		صباع
اوطان		وطن
كرماء		كريم
اصوات		صوت
حواجز		حاجز
صواريخ		صاروخ
قبور		قبر
ركلات		ركلة
اتراك		تركي
قبور		قبر
جنود		جندي
سجاير		سجارة
كراسي		كرسي
هدايا		هدية
احاديث		حاديث
طلقاء		طليق      
عرر			عرة
عناصر		عنصر
قضبان		قضبب
قهاوي		قهو
قواعد		قاعدة
كشوف		كشف
اصنام		صنم
بنات		بنت
بيوت		بيت
بنود		بند
نتاءج		نتيجة
ندوات		ندوة